NO          ./textures/wall_n.xpm
SO ./textures/wall_s.xpm
                 WE ./textures/wall_w.xpm
EA                       ./textures/wall_e.xpm
DC ./textures/door_closed.xpm



F                140    ,  140 ,                                 140



C 55    ,       198   ,  255


1111111111111111111111111111111111111111111111111111111111111111111111111111111111111111111111111111111111111111111111111111111
1E00000000000000000000000000000000000000000000000000000000000000000000000000000000000000000000000000000000000000000000000000001
1111111111111111111111111111111111111111111111111111111111111111111111111111111111111111111111111111111111111111111111111111111