NO          ./textures/wall.xpm
SO ./textures/wall.xpm
                 WE ./textures/wall.xpm
EA                       ./textures/wall.xpm



DO ./textures/wall.xpm
F               140       ,        140 ,    140



C 55    ,       198   ,  255
                                  111111
       111111                     100001
       100001                     100001111111111
       100001       111111        100000000000001
       100001       100001        100000000000001
       100001       100001        100001111110011    
       100001       100001        100001    1001
1111111111D1111111111111111111111110011111111001
        1000000001110000000000000000000000000001
111111111000000000000000000000000000111111111111
10000000000000000000000000000000000000000001
100000000000000000000000111100000001111111111
11111111111000000000000010010000000000000001
        1000000000000000111100000001111111111
111111111111111D11111111111111111111
110000000000000000000000000111111111
1000000111000000000000000001
10000000000000111100000000011111111
100000000000000000000000000000000W111111
1111111111D11111111111111111111110D00001
       100001                   11100001111111111
       100001       111111        100000000000001
       100001       100001        100000000000001
       100001       100001        111111111111111    
       100001       100001
       111111       111111