NO ./textures
SO ./textures/
WE ./textures/
EA ./textures/
DO ./textures/

F 220,100,0
C 225,30,0


11111111111111111111111111111111111
10000000000000000000000000000000001
10000000000000000000000000000000001
10000000000000000000000000000000001
10000000000000000000000000000000001
10000000000000000000000000000000001
10000000000000000000000000000000001
10000000000000000000000000000000001
10000000000000000000000000000000001
10000000000000000000000000000N00001
11111111111111111111111111111111111