NO ./textures
SO ./textures/
WE ./textures/
EA ./textures/
DO ./textures/

F 220,100,0
C 225,30,0
                                  111111
       111111                     100001
       100001                     100001111111111
       100001       111111        100000000000001
       100001       100001        100000000000001
       100001       100001        100001111110011    
       100001       100001        100001    1001
111111111101111111111111111111111110011111111001
        1000000001110000000000000000000000000001
111111111000000000000000000000000000111111111111
10000000000000000000000000000000000000000001
100000000000000000000000111100000001111111111
11111111111000000000000010010000000000000001
        1000000000000000111100000001111111111
111111111111111111111111111111111111
110000000000000000000000000111111111
1000000000000000000000000001
10000000000000000000000000011111111
10000000000000000000000000000N00001
11111111111111111111111111111111111