NO ./textures
SO ./textures/
WE ./textures/
EA ./textures/
DO ./textures/

F 220,100,0
C 225,30,0


1111111111 1111111111111111111111111
10000000011100000000000000000000001
100000000000000000000000000000000011
10000000000000000000000000000000001
10000000000000000000000000000000001
10000000000000000000000000011111111
1100000000000000000000000001
1000000000000000000000000001
10000000000000000000000000011111111
10000000000000000000000000000N00001
1111111111111111111111111111111111