NO          ./textures/wall.xpm
SO ./textures/wall.xpm
                 WE ./textures/wall.xpm
EA                       ./textures/wall.xpm



DO ./textures/wall.xpm
F               140       ,        140 ,    140



C 55    ,       198   ,  255

1111111111 1111111111111111111111111
10000000011100000000000000000000001
100000000000000000000000000000000011
10000000000000000000000000000000001
10000000000000000000000000000000001
11111001111111111111111111111111111
111111D111111111111111111111111
10000000000000000000000000011111111
1100000000000000000000000001
1000000000000000000000000001
10000000000000000000000000011111111
100000000000000E0000000000000000001
11111111111111111111111111111111111